..#....#...
.#.####.#..
#........#.
#.##.##..#.
#..#@#...#.
#..###...#.
#........#.
#..###...#.
.#......#..
..######...
...........